0 1 2 2 h
1 4 5 2 h
2 4 0 3 v
3 2 5 2 h
4 1 0 3 h
5 3 1 2 v