0 1 2 2 h
1 0 0 3 h
2 4 0 3 v
3 5 0 3 v
4 0 1 3 v
5 2 3 2 v
6 0 5 3 h
7 3 3 3 v
8 4 4 2 h