0 1 2 2 h
1 3 0 3 v
2 1 4 2 v
3 2 4 2 h
4 5 3 3 v