0 1 2 2 h
1 0 0 2 h
2 2 0 2 v
3 4 0 2 h
4 4 2 2 v
5 0 4 2 h
6 2 4 3 h
7 5 4 2 v