0 1 2 2 h
1 0 0 2 v
2 3 0 2 v
3 0 3 3 h
4 3 2 2 v
5 1 4 2 v
6 2 4 2 h
7 2 5 2 h
8 5 2 3 v