0 1 2 2 h
1 3 1 3 v
2 4 1 3 v
3 5 1 2 v
4 0 3 2 h
5 1 4 2 v
6 2 4 2 h
7 2 5 2 h