0 1 2 2 h
1 0 1 2 h
2 3 0 2 v
3 4 0 3 v
4 0 2 2 v
5 0 4 2 v
6 2 3 3 v
7 3 4 2 h
8 3 5 2 h
9 5 3 3 v 