0 1 2 2 h
1 0 0 2 v
2 2 0 2 v
3 3 1 2 h
4 5 0 3 v
5 3 2 2 v
6 4 3 2 h
7 0 3 2 v
8 1 3 3 v
9 2 4 3 h
10 2 5 3 h
