0 1 2 2 h
1 0 0 2 v
2 1 0 2 h
3 3 0 2 h
4 5 0 2 v
5 3 1 3 v
6 1 3 2 h
7 4 3 2 h
8 0 4 2 h
9 2 4 2 h
10 4 4 2 v