0 1 2 2 h
1 1 0 2 v
2 0 1 2 v
3 3 1 2 v
4 4 1 3 v
5 5 1 3 v
6 0 3 3 h
7 3 3 2 v
8 2 4 2 v
9 3 5 2 h