0 2 1 2 h
1 5 3 3 h
2 0 4 3 v
3 4 2 2 v
4 3 4 2 h