0 2 1 2 1
1 5 3 3 1
2 0 4 3 2
3 4 2 2 2
4 3 4 2 1