0 1 2 2 h
1 3 5 3 h
2 4 0 3 v
3 2 4 2 v
4 4 3 2 h