0 2 1 2 1
1 5 4 2 1
2 0 4 3 2
3 5 2 2 1
4 0 1 3 1
5 1 3 2 2