0 2 1 2 h
1 5 4 2 h
2 0 4 3 v
3 5 2 2 h
4 0 1 3 h
5 1 3 2 v