0 1 2 2 h
1 3 0 2 h
2 5 0 3 v
3 3 2 2 v
4 0 4 2 v
5 1 4 3 h
6 5 4 2 v