0 1 2 2 h
1 3 0 2 v
2 5 0 3 v
3 0 4 3 h
4 0 5 3 h
5 3 4 2 v
6 4 4 2 h